AlchemyChart	An alchemical chart
AnimalCells	the secret Court large animal holding cells
AnimalLab	a Court research lab
Anja	Anja Donlan, Kat’s mother
Annan	Annan Waters, a wide river in a deep gorge
Annie	Antimony Carver, our protagonist (Fire Head Girl)
AnnieCut	The cut on Annie's face from Jeanne’s sword
AntiGravGenerator	An anti-gravity generator that Kat made for the science fair
AntiGravShip	An anti-gravity ship that Kat made out of the anti-gravity generator
AntimonySymbol	The alchemical symbol for antimony; associated with Annie and Surma
Anwyn	could be described as tree elves but they don’t call themselves that
Basil	Minotaur
BeckyGround	A student
Bind	mystical binding hoodoo
BismuthSymbol	The alchemical symbol for bismuth; associated with the Court
Blackboard	classroom surface for writing on with chalk sticks a.k.a. chalkboard if not black
BlinkerStone	Etheric lens device
Blue	A crazy fairy obsessed with hair
Blush	happy/embarrassed
Bob	Bob Sutton, a gardener/maintainer of artificial habitats and keeper of Young’s Park with his wife, Marcia
Bobbie	A robot at the AnimalLab
Bonus	Extra pages at the end of the chapter
Boots	made for walking
Boxbot	see Terrible
Bridge	over the Annan Water to Gillitie Wood
Brinnie	Sultry childhood friend of Surma, Anja, Donny, Eggers &amp; co.
Caduceus	“Herald's staff” borne by Hermes (Mercury), symbol of commerce
Chickcharney	see Hardwick &amp; Little’s Bestiary, p65
CherryTree	Comes as advertised
Chester	One of the other school Houses
Circus	creepy and filled with clowns
CityFace	A pigeon
Classroom	Where they have classes
Clowns	creepy, no-one likes them
Coyote	Trickster; the creator of all; he does not exist, he says
CoyoteTooth	it’s a tooth, or is it?
Court	Gunnerkrigg Court, a mysterious institution that includes a boarding school
Cover	A chapter cover
CreatorGlyph	mark of the robots’ creator: now associated with Kat
Creeper	someone who is creeping
Crying	when salty water with enzymes comes out of one’s lacrimal ducts; also, a sign of sadness
Diego	former creepy robotics expert
DiegosStudy	home of all things ancient robot
Dolls	Kat probably only has action figures she thinks are hot: <i>i.e.</i> David Duchovny (Mulder), Batman and Hellboy
DonlanHouse	home of the Donlan family: Anja, Donny, Kat
Donny	Donald Donlan, Kat’s father
Dorm	Living quarters at school
DrDisaster	Sends the students on hologram simulation adventures!
Eglamore	Jimmy/Jim/James/Eggers. Big fellow with sword
EglamoreKnife	A switchblade/flick knife that Eglamore treasures
EnigmaronLair	Where the Enigmarons hang out
Enigmarons	Bad guy aliens in a simulation
Etherics	manipulation of the Ether – “magic”
EthericShield	An etheric/magical shield
EtherSymbol	Alchemical Symbol for Ether
EugeneGould	explorer
EyeSymbol	A crossed out eye that is a complex warding sign
Fairies	Gillitie Wood is full of them
Filler	not a mainstream story comic
Fire	an ancient element
FireSymbol	The alchemical symbol for fire
Foley	One of the other school Houses
Gamma	Gamma Czarnecki, a quiet Polish girl, friends with Zimmy
Gillitie	Gillitie Wood where the wild things are
GoodHope	Good Hope Hospital is where Surma was before she died
Gym	school gymnasium
Habitat	An environmental decontamination habitat
HabitatSymbol	The sign for an artificial habitat
Hall	Function hall 113, a hall in the school
HardwickLittleBestiary	Reference on mystical creatures
Headmaster	surprisingly grey, tired man, with bad posture
Heart	a heart sign, symbol, glyph or character
Hospital	The hospital within the court
Janet	Fierce daughter of the headmaster
Jeanne	vengeful ghost
Jones	a name of Wandering Eye
Kamlen	Anwyn boy about Annie’s and Kat’s age
Kat	Katerina Donlan
KatWorkshop	where Kat indulges her hobbies
Khepi	head of an anwyn family
Labyrinth	Not quite a maze
Landscape	a view of a wide expanse of land
LaserCow	A robotic cow that mows the lawns with its laser eyes. Also, awesome.
Lasers	Zap! Awesome!
LaundryList	a seagull
LeadSymbol	The alchemical symbol for lead; associated with protectors of the court such as Eglamore
Library	includes robot parts
Lindsey	giant crab creature / dorm caretaker
Lockpicks	Annie has some lockpicks which she stores in the WolfToy/Rey’s body
Marcia	Marcia Sutton, a keeper of Young’s Park with her husband, Bob
Margo	A student who enjoys singing. Friends with SullivansJohn
Matt	A student who is a classmate of Annie and Kat
MercurySymbol	The alchemical symbol for mercury; appears on Rey’s spirit form
Moon	Our most ancient satellite!
Mort	A ghost
Muut	Egyptian psychopomp (escorts the dead to the afterlife).
NapoleonHat	A fitting hat for Reynardine the Great!
Ocean	a whole bunch of water
Octopus	A floating octopus
Ogee	A city fairy with the power of rusting, who hangs out with a magpie called Bobeyes. Sister of Torus.
Orb	The <i>Globus cruciger</i>, a Christian symbol of power, wielded by monarchs and Christ
Parley	George Parley: Swordswoman (Big Nose Girl)
Paz	Spanish, good with animals
PrincessMononoke	animated movie by Hayao Miyazaki
Psychopomp	Escorts the dead to the afterlife/Ether
Queslett	Annie &amp; Kat’s school House
Red	A crazy and abrasive fairy
Rey	Reynardine/Renard, a crafty fox spirit
River	comes as advertised
Robot	Messianic S-13
Robotics	like Etherics but with metal
RobotTomb	tomb/theater full of robots
Robots	a collective noun
Robox	has no hands; awesome
RogatOrjak	Dragon-like giant
Roof	The top of the court
SeedOfBismuth	it’s a mystery
Shadow	the Thin Man
Shadowman	Not the Thin Man
Shadowmen	Creations of Coyote
SimRocket	A rocket in Dr Disaster's simulation
Simulation	One of Dr Disaster's holographic simulations
SivoBody	A deceased Rogat Orjak
Smitty	Andrew Smith: usually brings order from chaos (Mighty Eyebrows Boy)
StarOfDavid	Jewish and alchemical symbol
Stars	celestial bodies
Students	miscellaneous students
Sun	our closest star!
SullivansJohn	Sullivan’s John. A student who likes to play the mandolin
Surma	Surma Stibnite, Annie’s mother
Sword	Comes as advertised
Tea	explains things in-between chapters
Tears	in the eyes, visibly crying, etc
Teacher	a miscellaneous teacher
Terrible	see Boxbot
Thornhill	One of the other school Houses
TicToc	birdlike robotic watchers
Tony	Anthony Carver, Annie’s father
Torus	A city fairy who deals with pigeons such as City Face. Sister of Ogee.
Train	One of many trains that is used to commute in the court
TrainStation	One of many stations in the court
Treatise	Symbolic representation of the story
Trees	come as advertised (usually)
VII	The number seven, numerologically symbolises virginity, change, completion of a cycle, luck, perfection
WanderingEye	symbol of that which calls itself Jones, currently
Warehouse113	Not a secret base
WaterSymbol	Alchemical symbol for water
Winsbury	Not a very nice boy
WolfToy	A small wolf toy made by Annie’s mother
WoodenArm	A mysterious wooden arm from Gillitie
Ysengrin	Wolf/Tree hybrid demigod of the forest; Coyote’s General
Zimmy	aka Zeta, a strange girl who is friends with Gamma
